NO ./textures/redbrick.xpm
SO ./textures/bluestone.xpm
EA ./textures/purplestone.xpm
WE ./textures/wood.xpm

F 255,255,0
C 0,0,255

        1111111111111111111111111
        1000000000110000000000001
        1011000001110000000000001
        1001000000000000000000001
111111111011000001110000000000001
100000000011000001110111111111111
11110111111111011100000010001
11110111111111011111010010001
11000000110101011111000000001
10000000000000111100010000001
1000N000000000000110101001001
11000001110101011111010000001
11110111 1110101 101111010001
11111111 1111111 111111111111